X                                                                                                                              X
X                    D                                                                                                         X
X                     XXXX                                                                                                     X
X                          X                                                                                                   X
X                            X                                                                                                 X
X                                 XXXXXXX                      X                   X                                     X     X 
X                               X P                         XX    X    X      X               X     X    X     X     X         D
XXXXXX XX X   X XX X  X X X X X   XX  XX  XX XXX  X XX   X         XX     XX     XX   XX  XX     X    X     X     X      X X XXX
